abraham’s cone 	Khuôn hình cho?p cụt để đo độ sụt bê tông
absorption tes 	sự thử lực hâ?p thu 
abutmen 	tường chô?ng, chân vòm; mô? cầu
acceberated weatherin 	sự phong ho?a tăng nhanh
accelerated load tes 	sự thử chịu tải gia tăng 
accelerated tes 	sự thử gia tăng
acceleration 	?ẩy nhanh tiê?n độ
acceleration tes 	sự thử nghiệm gia tô?c 
accelerator, earlystrength admixtur 	Phụ gia tăng nhanh ho?a cư?ng bê tông
acceptance tes 	sự thử nghiệm thu 
acess to the site 	ra vào công trường
acid-resisting concrete 	bê tông chịu axit 
action effec 	hiệu quả hoạt động
actio 	ta?c động, ta?c dụng; sự hoạt động
activity schedule 	Biểu khô?i lượng công việc
actual load 	tải trọng thực, tải trọng co? i?ch 
actual tes 	sự thử nghiệm khai tha?c, sự thử nghiệm thực 
additional load 	tải trọng phụ thêm, tải trọng tăng thêm 
additive tes 	sự xa?c định hàm lượng châ?t phụ gia 
adhesion tes 	sự thử lực ba?m 
adjustable pro 	[cột, thanh chô?ng] điều chỉnh được
advance payment 	Tạm ư?ng
aerated concrete 	bê tông xô?p/ tổ ong 
a-frame (construction 	khung chữ A (kê?t câ?u)
after anchorin 	Sau khi neo xong cô?t the?p dự ư?ng lực
ageing tes 	sự thử lão ho?a 
agglomerate-foam conc. 	bê tông bọt thiêu kê?t/bọt kê?t tụ
air supported structur 	kê?t câ?u đỡ bằng khi? cầu
air tes 	sự thử độ ki?n; sự thử bằng không khi? ne?n 
air-entrained concrete 	bê tông co? phụ gia tạo bọt 
air-placed concrete 	bê tông phun 
allowable load 	tải trọng cho phe?p 
alloy stee 	the?p hợp kim
alloy(ed) stee 	The?p hợp kim
alternate load 	tải trọng đổi dâ?u 
alternate-stress tes 	sự thử ư?ng suâ?t đổi đầu 
altitude tes 	sự thử nghiệm trên cao; sự thử nghiệm độ cao 
anchor bol 	bulông neo
anchor plat 	bản neo
anchor slidin 	?ộ trượt trong mâ?u neo của đầu cô?t the?p
ancho 	ca?i neo
anchorage lengt 	Chiều dài đoạn neo giữ của cô?t the?p
angle ba 	the?p go?c
angle beam 	xà go?c; thanh giằng go?c 
angle brace/angle tie in the scaffold 	thanh giằng go?c ở giàn gia?o
angular tes 	sự thử kiểm tra, sự kiểm nghiệm ( 
antisymmetrical load 	tải trọng phản đô?i xư?ng 
apex load 	tải trọng ở nu?t (giàn)
approval of the contractor's temporary work 	Phê duyệt ca?c công trình tạm của Nhà thầu
arbitration tes 	sự thử nghiệm trọng tải (sự thử nghiệm để phân xử)
arch bridg 	cầu vòm
arc 	cuô?n, vòm; cửa cuô?n
architectural concrete 	bê tông trang tri?
area of reinforcemen 	Diện ti?ch cô?t the?p
armoured concrete 	bê tông cô?t the?p 
arrangement of longitudinales renforcement cut-ou 	Bô? tri? ca?c điểm că?t đư?t cô?t the?p dọc của dầm
arrangement of reinforcemen 	Bô? tri? cô?t the?p
articulated girder 	dầm ghe?p 
asphaltic concrete 	bê tông atphan 
assumed load 	tải trọng giả định, tải trọng ti?nh toa?n 
atmospheric corrosion resistant stee 	The?p chô?ng rỉ do khi? quyển
atrition tes 	sự thử mài mòn 
attached pie 	cột chô?ng; cột giả
average load 	tải trọng trung bình 
axial load 	tải trọng hươ?ng trục 
axle load 	tải trọng lên trục 
backproppin 	sự chô?ng xiên; thanh chô?ng xiên
back-shor 	[thanh, cọc] chô?ng xiên
bag of cement 	Bao xi măng
ba 	Bao tải (để dưỡng hộ bê tông)
balance beam 	đòn cân; đòn thăng bằng 
balanced load 	tải trọng đô?i xư?ng 
balancing load 	tải trọng cân bằng 
ballast concrete 	bê tông đa? dăm 
balloon-frame constructio 	kê?t câ?u khung nhà gỗ nhẹ
band-over tes 	sự thử bẻ cong 
bar (reinforcing bar 	Thanh cô?t the?p
base structur 	kê?t câ?u nền mo?ng
bas 	nền; mo?ng; bệ
basement of tamped (rammed) concrete 	mo?ng (tầng ngầm) làm bằng ca?ch đổ bê tông
baseplat 	tâ?m đệm, tâ?m lo?t
basic load 	tải trọng cơ bản 
batte 	sườn dô?c, ma?i dô?c; độ nghiêng mặt ngoài
beam of constant dept 	Dầm co? chiều cao không đổi
beam reinforced in tension and compressio 	Dầm co? cả cô?t the?p chịu ke?o và chịu ne?n
beam reinforced in tension onl 	Dầm chỉ co? cô?t the?p chịu ke?o
bearable load 	tải trọng cho phe?p 
bed load 	trầm ti?ch đa?y 
beddin 	Mo?ng cô?ng
before anchorin 	Trươ?c khi neo cô?t the?p dự ư?ng lực
bend(ing) tes 	sự thử uô?n 
bending load 	tải trọng uô?n 
bending strength 	?ộ bền uô?n
bent-up ba 	Cô?t the?p uô?n nghiêng lên
best load 	công suâ?t khi hiệu suâ?t lơ?n nhâ?t (tuabin) 
bituminous concrete 	bê tông atphan 
blank tes 	sự thử bâ?t kỳ, mẫu thử ngẫu nhiên 
blow tes 	sự thử sư?c chịu va đập; sự thử độ bền va đập 
blow-bending tes 	sự thử uô?n va đập 
bond beam 	dầm nô?i 
bonded tendo 	Cô?t the?p dự ư?ng lực co? di?nh ba?m vơ?i bê tông
bonded tendo 	Cô?t the?p dự ư?ng lực co? di?nh ba?m vơ?i bê tông
bored pil 	Cọc khoan nhồi
boring tes 	sự thử bằng khoan
bottom latera 	Thanh giằng che?o ở mọc hạ của dàn
bottom reinforcemen 	Cô?t the?p bên dươ?i (của mặt că?t)
bow girder 	dầm cong 
bowstring girder 	giàn biên cong 
box beam 	dầm hình hộp 
box girder 	dầm hộp 
braced girder 	giàn co? giằng tăng cư?ng 
braced membe 	Thanh giằng ngang
bracing beam 	dầm tăng cư?ng 
bracin 	Giằng gio?
bracket load 	tải trọng lên dầm chìa, tải trọng lên công xôn 
brake beam 	đòn hãm, cần hãm 
brake load 	tải trọng hãm 
break-down tes 	sự thử đư?t; sự thử gãy 
breaking load 	tải trọng pha? hủy 
breaking strength 	Giơ?i hạn bền, sư?c chô?ng pha? huỷ
breaking tes 	sự thử đư?t; sự thử gãy 
breast beam 	tâ?m tì ngực; (đường să?t) thanh chô?ng va, 
breeze concrete 	bê tông bụi than cô?c 
brick 	Gạch
brick girder 	dầm gạch cô?t the?p 
brick wall 	Tường gạch
bricklayer /brickmason 	Thợ nề
bricklayer's hammer (brick hammer) 	bu?a thợ nề
bricklayer's labourer/builder's labourer 	Phụ nề, thợ phụ nề
bricklayer's tools 	Ca?c dụng cụ của thợ nề
bridge beam 	dầm cầu 
bridge tes 	sự xa?c định bằng cầu điện trở 
brinell hardness tes 	sự thử độ cư?ng Brinell 
brittleness tes 	sự thử độ giòn 
broad flange beam 	dầm co? ca?nh bản rộng (Dầm I, T) 
broken concrete 	bê tông dăm, bê tông vỡ 
buckling load 	tải trọng uô?n dọc tơ?i hạn, tải trọng mâ?t ổn định dọc 
buckling strength 	Cường độ uô?n dọc
buffer beam 	thanh chô?ng va, thanh giảm châ?n (tàu hỏa) 
buiding site 	Công trường xây dựng
builder's hoist 	Ma?y nâng dùng trong xây dựng
building site latrine 	Nhà vệ sinh tại công trường xây dựng
build-up girder 	dầm ghe?p 
built up sectio 	the?p hình tổ hợp
bump tes 	sự thử uô?n 
bumper beam 	thanh chô?ng va, thanh giảm châ?n (tàu hỏa), dầm đệm 
bunched beam 	chùm nho?m 
buried concrete 	bê tông bị phủ đâ?t 
bursting concrete stres 	ư?ng suâ?t vỡ tung của bê tông
bush-hammered concrete 	bê tông được đàn bằng bu?a
cable dispositio 	Bô? tri? cô?t the?p dự ư?ng lực
calibration tes 	sự thử định chuẩn 
calorimeter tes 	sự thử bằng nhiệt lượng kê?; sự đo nhiệt lượng 
camber beam 	dầm cong, dầm vồng 
cantilever arched girder 	dầm vòm đỡ; giàn vòm công xôn 
cantilever beam 	dầm công xôn, dầm chìa 
capacitive load 	tải dung ti?nh (điện) 
capping beam 	dầm mũ dọc 
carbon penetration tes 	sự thử độ thâ?m cacbon 
carbon stee 	The?p ca?c bon (the?p than)
carbon tes 	sự thử hàm lượng cacbon 
carbonization tes 	sự thử cacbon ho?a; sự thử ti?nh oxi ho?a 
carcase (cacass, farbric) [ house construction, carcassing] 	khung sườn (kê?t câ?u nhà)
cased beam 	dầm the?p bọc bê tông 
cast concrete 	bê tông đu?c 
cast in many stage phrase 	?ổ bê tông theo nhiều giai đoạn
cast in plac 	?u?c bê tông tại chỗ
cast in situ place concret 	Bê tông đu?c tại chỗ
cast in situ structure (slab, beam, column 	Kê?t câ?u đu?c bê tông tại chỗ (dầm, bản, cột)
cast stee 	The?p đu?c
cast,(casting 	?ổ bê tông (sự đổ bê tông)
castellated beam 	dầm thủng 
castelled sectio 	the?p hình bụng rỗng
casting schedul 	Thời gian biểu của việc đổ bê tông
cast-in-place bored pil 	Cọc khoan nhồi đu?c tại chỗ
cast-in-place concrete caisso 	Giê?ng chìm bê tông đu?c tại chỗ
cast-in-place concrete pil 	Cọc đu?c bê tông tại chỗ
cast-in-place, posttensioned bridg 	Cầu dự ư?ng lực ke?o sau đu?c bê tông tại chỗ
cast-in-situ flat place sla 	Bản mặt cầu đu?c bê tông tại chỗ
catenary arc 	cuô?n co? dạng xi?ch treo
cathode beam 	chùm tia catôt, chum tia điện tử 
cauplin 	Nô?i cô?t the?p dự ư?ng lực
cellar window (basement window 	ca?c bậc cầu thang bên ngoài tầng hầm
cellular concrete 	bê tông tổ ong 
cellular girder 	dầm rỗng lòng 
cement 	Xi măng
cement concrete 	bê tông xi măng 
center spira 	Lõi hình xoă?n ô?c trong bo? sợi the?p
centre point load 	tải trọng tập trung 
centric load 	tải trọng chi?nh tâm, tải trọng dọc trục 
centrifugal load 	tải trọng ly tâm 
centrifuge tes 	sự thử ly tâm; sự thử bằng ma?y ly tâm 
changes in activity schedule 	Thay đổi lịch tiê?n độ
changing load 	tải trọng thay đổi 
channel sectio 	the?p hình chữ U
characteristic strength 	?ộ bền đặc trưng
check tes 	sự thử kiểm tra 
checking concrete qualit 	Kiểm tra châ?t lượng bê tông
chillid stee 	The?p đã tôi
chimney 	ô?ng kho?i (lò sưởi)
chimney bond 	ca?ch xây ô?ng kho?i 
chopped beam 	tia đư?t đoạn 
chuting concrete 	bê tông lỏng 
cinder concrete 	bê tông xỉ 
circulating load 	tải trọng tuần hoàn 
clarke beam 	dầm ghe?p bằng gỗ 
closure join 	Mô?i nô?i hợp long (đoạn hợp long)
closure tes 	sự thử ne?n hê?t cỡ (lò xo)
coatin 	Vật liệu phủ để bảo vệ cô?t the?p DưL khỏi rỉ hoặc giảm ma sa?t khi căng 
cobble concrete 	bê tông cuội sỏi 
cold rolled stee 	the?p ca?n nguội
cold temperature tes 	sự thử ở nhiệt độ thâ?p 
cold tes 	sự thử lanh; sự thử ở nhiệt độ thâ?p 
cold weather tes 	sự thử trong thời tiê?t lạnh 
cold-and-hot tes 	sự thử no?ng-lạnh, sự thử bằng nung no?ng-làm lạnh 
collapse load 	tải trọng pha? hỏng, tải trọng
collapsible beam 	dầm tha?o lă?p được 
collar beam 	dầm ngang, xà ngang; thanh giằng (vì kèo) 
combination beam 	dầm tổ hợp, dầm ghe?p 
combined load 	tải trọng phô?i hợp 
commercial concrete 	bê tông trộn sẵn 
communications 	Ca?c biện pha?p thông tin liên lạc
compensation events 	Ca?c trường hợp bồi thường
compession tes 	sự thử ne?n 
completion date 	Ngày hoàn thành
completion of contract 	Hoàn thành hợp đồng
composit beam 	dầm hợp thể, dầm vật liệu hỗn hợp 
composite load 	tải trọng phư?c hợp 
composite steel and concrete structur 	Kê?t câ?u liên hợp the?p – bê tông cô?t the?p
composite steel and concrete structur 	Kê?t câ?u liên hợp the?p – bê tông cô?t the?p
compound beam 	dầm hỗn hợp
compound girder 	dầm ghe?p 
comprehensive tes 	sự thử toàn diện 
compremed concrete zon 	Vùng bê tông chịu ne?n
compression reinforcement 	cô?t (the?p); cô?t, sườn 
compression reinforcemen 	Cô?t the?p chịu ne?n
compressive load 	tải trọng ne?n 
compressive strength 	Ư?ng suâ?t chịu ne?n
concentrated load 	tải trọng tập trung 
concrete age at prestressing tim 	Tuổi của bê tông lu?c tạo dự ư?ng lực
concrete aggregate (sand and gravel) 	cô?t liệu bê tông (ca?t và sỏi)
concrete base course 	cửa sổ tầng hầm
concrete compositio 	Thành phần bê tông
concrete cove 	Bê tông bảo hộ (bên ngoài cô?t the?p)
concrete floor 	Sàn bê tông
concrete hing 	Chô?t bê tông
concrete mixer/gravity mixer 	Ma?y trộn bê tông
concrete proportionin 	Công thư?c pha trộn bê tông
concrete stress at tendon leve 	ư?ng suâ?t bê tông ở thơ? đặt ca?p dự ư?ng lực
concrete surface treatemen 	Xử ly? bề mặt bê tông
concrete test hamme 	Su?ng bật nảy để thử cường độ bê tông
concrete thermal treatemen 	Xử ly? nhiệt cho bê tông
concrete unit weight, density of concret 	Trọng lượng riêng bê tông
concret 	Bê tông
concrete-filled pipe pil 	Cọc ô?ng the?p nhồi bê tông lâ?p lòng
condition of curin 	?iều kiện dưỡng hộ bê tông
cone tes 	sự thử nghiệm (độ sụt vữa bê tông) bằng chùy hình no?n 
conjugate beam 	dầm trang tri?, dầm giả 
connect by hing 	Nô?i khơ?p
connected load 	tải trọng liên kê?t 
connection strand by stran 	Nô?i ca?c đoạn ca?p dự ư?ng lực Ke?o sau
connectio 	Ghe?p nô?i
connecto 	Neo (của dầm the?p liên hợp bản BTCT)
consistency test of concret 	sự thử nghiệm độ sụt của vữa bê tông 
constant load 	tải trọng không đổi, tải trọng tĩnh 
construction successive stage(s 	(Ca?c) Giai đoạn thi công nô?i tiê?p nhau
continuity tes 	sự thử ti?nh liên tục 
continuous beam 	dầm liên tục
continuous concrete 	bê tông liền khô?i 
continuous girder 	dầm liên tục 
continuous load 	tải trọng liên tục; tải trọng phân bô? đều 
contract dat 	Dữ liệu Hợp đồng
contract price 	Gia? Hợp đồng
contractor to construct the works 	Nhà thầu phải thi công Công trình
contractor's name plate 	Biển ghi tên Nhà thầu
contractor's risks 	Rủi ro của Nhà thầu
controlling beam 	tia điều khiển 
convergent beam 	chùm hội tụ
copper clad stee 	the?p mạ đồng
corner connecto 	Neo kiểu the?p go?c
correction of defects 	Sửa chữa sai so?t
corroded reinforcemen 	Cô?t the?p đã bị rỉ
cost control 	Kiểm soa?t chi phi?
cost of repairs 	Chi phi? sửa chữa
coupler (coupling 	Mô?i nô?i ca?p dự ư?ng lực Ke?o sau
couple 	?ầu nô?i để nô?i ca?c cô?t the?p dự ư?ng lực
coupleu 	Bộ nô?i ca?c đoạn ca?p dự ư?ng lực ke?o sau
cover ( boards) for the staircase 	Tâ?m che lồng cầu thang
cover plat 	Bản the?p phủ (ở phần bản ca?nh dầm the?p )
cover-meter, rebar locato 	Ma?y đo lơ?p bê tông bảo hộ cô?t the?p
cover-meter, rebar locato 	Ma?y đo lơ?p bê tông bảo hộ cô?t the?p
cover-plat 	Bản nô?i ô?p, bản ma?
crane beam 	dầm cần trục 
crane girder 	gia? cần trục; giàn cần trục 
crane load 	sư?c nâng của cần trục, trọng tải của cần trục 
creep strength 	?ộ bền từ biê?n
creep tes 	sự thử độ rão; sự thử độ lưu biê?n 
creep-rupture tes 	sự thử độ rão-gãy 
crippling load 	tải trọng pha? hủy 
crippling tes 	sự thử uô?n dọc; sự thử uô?n đi uô?n lại 
critical load 	tải trọng tơ?i hạn 
cross beam 	dầm ngang, xà ngang 
cross girder 	dầm ngang 
crushing load 	tải trọng nghiền, tải trọng ne?n vỡ 
crushing machin 	Ma?y ne?n mẫu thử bê tông
crushing strength 	?ộ bền ne?n vỡ
crushing tes 	sự thử ne?n vỡ 
cube strength 	?ộ bền ne?n ba phương
curb girder 	đa? vỉa; dầm cạp bờ
cure to cure, curin 	Dưỡng hộ bê tông mơ?i đổ xong
curing temperatur 	Nhiệt độ dưỡng hộ bê tông
curin 	Bảo dưỡng bê tông trong lu?c ho?a cư?ng
currencies 	Ca?c loại tiền tệ
cutting machin 	Ma?y că?t cô?t the?p
cutting strength 	Ư?ng lực că?t
cyclic load 	tải trọng tuần hoàn 
cyclopean concrete 	bê tông đa? hộc 
cylinder, test cylinde 	Mẫu thử bê tông hình trụ
damping tes 	sự thử giảm xo?c, sự thử giảm âm; sự thử thâ?m 
daywork 	Công việc công nhật
dead load 	tĩnh tải 
dead weight load 	tĩnh tải 
de-aerated concrete 	bê tông (đu?c trong) chân không 
deck girder 	giàn cầu 
deck plate girde 	Dầm bản the?p co? đường xe chạy trên
deep foundatio 	Mo?ng sâu
defect notice period 	Thời gian thông ba?o về sai so?t (tương đương vơ?i nghĩa là thời gian bảo hành)
defects 	Sai so?t (kỹ thuật)
definitions 	Ca?c định nghĩa
deflection tes 	sự thử uô?n 
deformation tes 	sự thử biê?n dạng 
deformed bar, deformed reinforcemen 	Cô?t the?p co? gờ (cô?t the?p gai)
deformed reinforcemen 	Cô?t the?p co? độ di?nh ba?m cao (co? gờ)
deformed reinforcemen 	Cô?t the?p co? độ di?nh ba?m cao (co? gờ)
degign action effec 	hiệu quả hoạt động thiê?t kê?
delegation 	?ại diện
demand load 	tải trọng yêu cầu 
dense concrete 	bê tông nặng
depth of bea 	Chiều cao dầm
dept 	Chiều cao
design load 	tải trọng ti?nh toa?n, tải trọng thiê?t kê? 
destructive tes 	sự thử pha? hủy 
diagnostic tes 	sự thử chẩn đoa?n
diagonal reinforcement 	cô?t (the?p) xiên, cô?t (the?p) đặt che?o 
dile splicin 	Nô?i dài cọc
direct-acting load 	tải trọng ta?c động trực tiê?p 
discontinuous load 	tải trọng không liên tục 
discoveries 	Những thư? pha?t hiện được (khi thi công)
disposable load 	tải trọng co? i?ch 
dispute 	tranh châ?p
distributed load 	tải trọng phân bô? 
distributing reinforcement 	cô?t (the?p) phân bô? 
distribution reinforcemen 	Cô?t the?p phân bô?
divergent beam 	chùm phân kỳ 
double angl 	the?p go?c ghe?p thành hình T
double strut trussed beam 	dầm tăng cư?ng hai trụ chô?ng 
draw beam 	dầm nâng, cần nâng 
drawbar load 	lực ke?o ở mo?c 
drawbar tes 	sự thử thanh ke?o 
drill tes 	sự thử khoan 
drop tes 	sự thử va dập; sự thử thả rơi; sự thử sụt điện a?p 
drum tes 	sự thử gõ đập 
dry concrete 	bê tông trộn khô, vữa bê tông cư?ng 
dry gunitin 	Phun bê tông khô
duc 	ô?ng chư?a cô?t the?p dự ư?ng lực
dummy load 	tải trọng giả 
dummy tes 	sự thử mô hình; sự thử hình mẫu 
duplicate tes 	sự thử lặp lại 
during stressing operatio 	Trong qua? trình Ke?o căng cô?t the?p
dynamic strength 	?ộ bền động, độ bền va chạm
dynamic tes 	sự thử động lực 
dynamic(al) load 	tải trọng động lực học 
early strenght concrete 	bê tông mau cư?ng 
early strength concret 	Bê tông ho?a cư?ng nhanh
early warning 	Cảnh ba?o trươ?c
earthquake tes 	sự thử sư?c bền động đâ?t, sự thử sư?c chịu động đâ?t 
eccentric load 	tải trọng lệch tâm 
effective depth at the sectio 	Chiều cao co? hiệu
effiency tes 	sự thử công suâ?t, sự thử năng suâ?t; sự thử hiệu suâ?t 
efflorescenc 	ô? mầu trên bề mặt bê tông
elastic limit load 	tải trọng giơ?i hạn đàn hồi 
elastic strength 	?ộ bền đàn hồi
elastomatric bearin 	Gô?i cao su
elliptical arc 	cuô?n hình elip
elongation tes 	sự thử ke?o dài; sự thử độ ke?o dài 
employer's risk 	Rủi ro của Chủ đầu tư
end bearing capacity 	Sư?c chô?ng mũi
end girder 	dầm gô?i tường 
endưquench tes 	sự thử độ thâ?m tôi 
endurance tes 	sự thử độ bền; sự thử sư?c chịu đựng 
endurance-tension tes 	sự thử độ bền ke?o, sự thử sư?c chịu ke?o 
enduranceưtorsion tes 	sự thử độ bền xoă?n, sự thử sư?c chịu xoă?n 
english bond 	Xê?p mạch kiểu Anh
english cross bond/saint andrew's cross bond 	ca?ch xây che?o kiểu Anh
epingle pi 	Cô?t the?p găm (để truyền lực că?t trượt như neo)
equalizing beam 	đòn cân bằng 
equipment for the distribution of concret 	Thiê?t bị phân phô?i bê tông
equivalent load 	tải trọng tương đương
erection reinforcemen 	Cô?t the?p thi công
even load 	tải trọng đều, tải trọng phân bô? đều 
excess concrete 	vữa bê tông phân lơ?p 
expanded slag concrete 	bê tông xỉ nở 
exposed concrete 	bê tông mặt ngoài(công trình) 
exposed reinforcemen 	Cô?t the?p lộ ra ngoài
exposure tes 	sự thử phơi sa?ng
extension of intended completion date 	Gia hạn ngày hoàn thành dự kiê?n
external prestressed concret 	Bê tông cô?t the?p dự ư?ng lực ngoài
fabric reinforcement 	cô?t (the?p) lươ?i 
face-bend tes 	sự thử uô?n bề mặt (thử mô?i hàn) 
failing load 	tải trọng pha? hủy 
failure-rate tes 	sự thử tô?c độ pha? hủy 
fan beam 	chum tia hình quạt 
fascia beam 	dầm co? ca?nh 
fascia girder 	dầm biên 
fatigue strength 	Giơ?i hạn mỏi
fatigue tes 	sự thử độ mỏi
feeder skip 	Thùng tiê?p liệu
fence 	bờ rào, tường rào
fender beam 	dầm chă?n 
fibrous concrete 	bê tông sợi 
fictitious load 	tải trọng ảo 
field connection use high strength bol 	Mô?i nô?i ở hiện trường bằng bu lông cường độ cao
field connection use high strength bol 	Mô?i nô?i ở hiện trường bằng bu lông cường độ cao
field connectio 	Mô?i nô?i ở hiện trường
field tes 	sự thử ở hiện trường
final account 	Quyê?t toa?n
fine concrete 	bê tông mịn 
first course 	hàng /lơ?p gạch đầu tiên
first floor ( second floor nê?u là tiê?ng anh mỹ ) 	Lầu một (tiê?ng Nam), tầng hai (tiê?ng Bă?c)
fish-bellied beam 	dầm phình giữa, dầm bụng ca? (để co? sư?c bền đều) 
fix the ends of reinforcemen 	Giữ cô? định đầu cô?t the?p
fixation on the for 	Giữ cho cô? định vào va?n khuôn
fixed beam 	dầm ngàm hai đầu, dầm cô? định 
fixed load 	tải trọng cô? định, tải trọng không đổi 
flange reinforcemen 	Cô?t the?p bản ca?nh
flanged beam 	dầm co? bản ca?nh, dầm co? gờ; dầm chữ I 
flat ba 	the?p dẹt
flat pratt girder 	dầm flat phẳng
flexible sheat 	ô?ng mềm (chư?a ca?p, the?p DƯL)
flexural strength 	Giơ?i hạn bền uô?n
float 	bàn xoa
floated concrete 	(vữa) bê tông nhão/bê tông chảy lỏng 
floor beam 	dầm sàn 
flow test of concet 	sự thử độ sụt (hình no?n) của vữa bê tông 
flow tes 	sự thử ti?nh lưu động của vật liệu (sơn, vữa...) 
fluctuating load 	tải trọng dao động 
fly-ash concrete 	bê tông bụi tro
foam concrete 	bê tông bọt 
footin 	Bệ mo?ng
forces on parapet 	Lực lên lan can
form exterior face 	Bề mặt va?n khuôn
form remova 	Dỡ va?n khuôn
form vibrato 	?ầm cạnh (rung va?n khuôn)
for 	Va?n khuôn
fouilk, boucho 	Bê tông bịt đa?y (của mo?ng Ca?p cọc, của giê?ng, của hô?)
foundation bea 	dầm mo?ng
foundation girder 	dầm mo?ng 
foundation materia 	Vật liệu của mo?ng
foundation soi 	?â?t nền bên dươ?i mo?ng
foundatio 	Mo?ng
fractural strength 	Sư?c cản đư?t
fracture tes 	sự thử đư?t gãy 
frame girder 	giàn khung 
frame reinforcement 	cô?t (the?p) giàn 
free beam 	dầm tự do 
free-bend tes 	sự thử uô?n tự do 
free-fall tes 	sự thử rơi tự do 
freezing tes 	sự thử đông lạnh; sự thử ti?nh chịu đông lạnh 
fresh concrete 	bê tông mơ?i đổ 
fresh concret 	Bê tông tươi (mơ?i trộn xong)
friability tes 	sự thử độ giòn 
frictional strength 	?ộ bền ma sa?t
front beam 	dầm trươ?c 
fuel consumption tes 	sự thử nghiệm tiêu hao nhiên liệu 
full load 	tải trọng toàn phần 
full-scale tes 	sự thử nguyên cỡ; sự thử mô hình nguyên cỡ 
galvanised stee 	the?p mạ kẽm
gas concrete 	bê tông xô?p 
gate 	Cửa
general conditions of contract 	Ca?c điều kiện chung của Hợp đồng
glass concrete 	bê tông thủy tinh 
glass-reinforced conc. 	bê tông cô?t thủy tinh
glavel concrete 	bê tông (cô?t liệu) sỏi 
glazed concrete 	bê tông trong 
gluing of steel plat 	Da?n bản the?p
grade of concret 	Câ?p của bê tông
grade of reinforcemen 	Câ?p của cô?t the?p
grad 	Câ?p (của bê tông, của …)
gradually applied load 	sự châ?t tải tăng dần 
granolithic concrete 	bê tông granit
grating beam 	dầm ghi lò 
gravity load 	tải trọng bản thân, tự trọng 
green concrete 	bê tông mơ?i đổ 
green tes 	sự thử chạy rà 
grillage reinforcement 	cô?t (the?p) lươ?i sợi 
grinding tes 	sự thử khả năng gia công bằng mài, sự thử bằng mài 
gross load 	tải trọng tổng, tải trọng toàn phần 
ground ancho 	neo (vào) đâ?t 
ground floor (hoặc first floor nê?u là tiê?ng anh mỹ) 	tầng trệt (tiê?ng Nam), tầng một (tiê?ng Bă?c)
groutin 	Phun vữa lâ?p lòng ô?ng chư?a cô?t the?p dự ư?ng lực
guard board 	tâ?m chă?n, tâ?m bảo vệ
gunned concrete 	bê tông phun 
gusset plat 	Bản nu?t, bản tiê?t điểm
gust load 	(hàng không) tải trọng khi gio? giật 
gypsum concrete 	bê tông thạch cao 
h- beam 	dầm chữ H 
half- beam 	dầm nửa 
half-latticed girder 	giàn nửa mă?t ca?o 
hammer beam 	dầm hẫng, dầm chìa, dầm công xôn 
hand rai 	Lan can
hanging beam 	dầm treo 
hanging tes 	sự thử ke?o đư?t bằng treo 
hard rock concrete 	bê tông (cô?t liệu) đa? cư?ng 
hard stee 	the?p cư?ng
hardenet concrete 	bê tông đã đông cư?ng 
hardness tes 	sự thử độ cư?ng 
haydite concrete 	bê tông keramit 
hdpe sheat 	Vỏ bọc polyetylen mật độ cao của ca?p dự 
head beam 	dầm mũ cọc 
heading bond 	ca?ch xây hàng ngang (gạch xây ngang)
heading course 	hàng, lơ?p xây ngang
heaped concrete 	bê tông chưa đầm
heat load 	tải trọng do nhiệt 
heat tes 	sự thử bằng nung no?ng 
heat-resistant concrete 	bê tông chịu nhiệt 
heavy concrete 	bê tông nặng 
heavy weight concret 	Bê tông nặng
helical reinforcement 	cô?t (the?p) xoă?n 
high beam 	đèn rọi xa, chùm sa?ng rọi xa 
high slump concrete 	bê tông chảy 
high strength concret 	Bê tông cường độ cao
high strength stee 	The?p cường độ cao
high strength stee 	The?p cường độ cao
high tech work techniqu 	Công trình kỹ thuật cao
high tensile stee 	the?p cường độ cao
high yield stee 	the?p đàn hồi cao
highest flood leve 	Mư?c nươ?c lũ cao nhâ?t
high-strength materia 	Vật liệu cường độ cao
hight densit 	ô?ng bằng polyetylen mật độ cao
hinged beam 	dầm đòn ga?nh, dầm quay quanh bản lề ở giữa 
hinged cantilever girder 	dầm đỡ - ghe?p bản lề 
hinged girder 	dầm ghe?p bản lề 
hold beam 	dầm khô (dầm tàu ở chỗ khô) 
hol 	Lỗ thủng, lỗ khoan
hollow block wall 	Tường xây bằng gạch lỗ (gạch rỗng)
hollow sectio 	the?p hình rỗng
hoo 	Mo?c câu (ở đầu cô?t the?p)
hoop reinforcemen 	Cô?t the?p đặt theo vòng tròn
hooped concrete 	bê tông cô?t the?p vòng 
hose (hosepipe) 	ô?ng nươ?c - Chu? thi?ch ở đây là loại ô?ng mềm như dạng ô?ng nhựa dùng để rửa xe â?y
hot rolled stee 	the?p ca?n no?ng
hot tes 	sự thử bằng nung no?ng 
hot-bending tes 	sự thử uô?n no?ng 
hot-laid asphaltic conc 	bê tông atphan đu?c no?ng 
hot-load tes 	sự thử tải nhiệt (sự thử độ chịu nhiệt khi co? tải) 
hot-mixed asphaltic con 	bê tông atphan trộn no?ng 
hydraulic concret 	Bê tông thủy công
hydraulic tes 	sự thử thủy lực 
hydrostatic tes 	sự thử thủy tĩnh 
i- beam 	dầm chữ I 
i- girder 	dầm chữ I 
identifying defects 	Pha?t hiện sai so?t
impact bend tes 	sự thử uô?n va đập 
impact compression tes 	sự thử ne?n va đập 
impact endurance tes 	sự thử độ bền va đập 
impact hardness tes 	sự thử độ cư?ng va đập 
impact load 	tải trọng va đập 
impact strength 	Lực chô?ng va đập
impact tes 	sự thử va đập, sự thử da?t 
imposed load 	tải trọng đặt vào 
impulse tes 	sự thử bằng xung 
impulsive load 	tải trọng va đập, tải trọng xung 
inclined ba 	Cô?t the?p nghiêng
incompletely compacted  	bê tông đầm chưa đủ
increment load 	tải trọng phụ 
indemnities 	Bồi thường
independent girder 	dầm phụ, dầm rồi 
indivisible load 	tải trọng không chia nhỏ được 
inductive load 	tải trọng cảm ư?ng 
initial load 	tải trọng ban đầu 
in-situ concrete 	bê tông đổ tại chỗ
in-situ material tes 	sự thử nghiệm vật liệu tại hiện trường 
instantaneous load 	tải trọng tư?c thời 
insulating concrete 	bê tông ca?ch nhiệt 
insuranc 	Bảo hiểm
intermittent load 	tải trọng gia?n đoạn 
internal prestressed concret 	Bê tông cô?t the?p dự ư?ng lực trong
internal prestressed concret 	Bê tông cô?t the?p dự ư?ng lực trong
internal vibrato 	?ầm trong (vùi vào hỗn hợp bê tông)
interpretation 	Diễn giải
intrinsic fatigue-limit tes 	sự thử giơ?i hạn mỏi nội tại
ion beam 	chùm ion 
irregularly distributed loa 	tải trọng phân bô? không đều 
isteg reinforcement 	cô?t (the?p) co? gờ 
jacking en 	?iểm đầu cô?t the?p được ke?o căng bằng ki?ch
jacking forc 	Lực ki?ch (để Ke?o căng cô?t the?p)
jamb 	?ô? dọc cửa, thanh đư?ng khuôn cửa
job-placed concrete 	bê tông đổ tại chỗ 
joggle beam 	dầm ghe?p mộng 
joint beam 	thanh giằng, thanh liên kê?t 
junior beam 	dầm bản nhẹ 
king post girder 	dầm tăng cư?ng một trụ 
laboratory simulation tes 	sự thử bằng phương pha?p mô phỏng trong phòng thi? nghiệm 
laboratory tes 	sự thử trong phòng thi? nghiệm 
ladder 	ca?i thang
laminated beam 	dầm thanh 
laminated stee 	The?p ca?n
landing beam 	chùm sa?ng dẫn hươ?ng hạ ca?nh 
language and law 	Ngôn ngữ và luật (a?p dụng cho hợp đồng) 
la 	Mô?i nô?i chồng lên nhau của cô?t the?p
laser beam 	chùm tia laze 
lateral bracin 	Hệ giằng liên kê?t của dàn
lateral load 	tải trọng ngang 
lateral reinforcement 	cô?t (the?p) ngang 
lateral strength 	?ộ bền chô?ng lực ngang
latrine 	nhà vệ sinh
lattice beam 	dầm lươ?i, dầm mă?t ca?o 
lattice girder 	giàn mă?t ca?o 
laying - on - trowel 	bàn san vữa
leak (age) tes 	sự thử độ rò 
lean concrete 	bê tông nghèo, bê tông châ?t lượng thâ?p 
lean concrete (low grade concrete 	Bê tông nghèo
ledger 	thanh ngang, gio?ng ngang (ở giàn gia?o)
letter of acceptance 	Thư châ?p thuận
levelin 	Cao đạc
levelling instrumen 	Ma?y cao đạc (ma?y thủy bình)
levelling poin 	?iểm cần đo cao độ
life tes 	sự thử tuổi thọ, sự thử thời gian sử dụng 
lifting beam 	dầm nâng tải 
ligature, ti 	Dây the?p buộc
light beam 	chùm tia sa?ng 
light load 	tải trọng nhẹ 
light weight concret 	Bê tông nhẹ
light-weight concrete 	bê tông nhẹ 
lime concrete 	bê tông vôi 
limit load 	tải trọng giơ?i hạn 
limit strength 	?ộ bền giơ?i hạn
linearly varying load 	tải trọng biê?n đổi tuyê?n ti?nh 
lintel (window head) 	Lanh tô cửa sổ
liquid concrete 	bê tông lỏng 
liquidated damage 	Bồi thuờng thiệt hại
live load 	tải trọng động; hoạt tải 
live tes 	sự thử nghiệm co? người (trong khoang tàu thi? nghiệm) 
load due to own weight 	tải trọng do khô?i lượng bản thân; 
load due to wind 	tải trọng do gio?; 
load in bulk 	châ?t thành đô?ng; 
load on axle 	tải trọng lên trục; 
load out 	giảm tải, dỡ tải; 
load per unit length 	tải trọng trên một đơn vị chiều dài 
load tes 	sự thử co? tải trọng 
load up 	châ?t tải 
loading tes 	sự thử bằng tải trọng 
location of the concrete compressive resultan 	?iểm đặt hợp lực ne?n bê tông
long-duration tes 	sự thử dài hạn, sự thử thời gian sử dụng dài 
longitudinal beam 	dầm dọc, xà dọc 
longitudinal girder 	dầm dọc, xà dọc 
longitudinal reinforcement 	cô?t (the?p) dọc 
longitudinal reinforcemen 	Cô?t the?p dọc
long-run tes 	sự thử vận hành dài hạn, sự thử vận hành lâu, sự thử làm việc lâu 
loosely spread concrete 	bê tông chưa đầm, bê tông đổ dô?i 
loss due to concrete instant deformation due to non-simultaneous prestressing of several strand 	Mâ?t ma?t dự ư?ng suâ?t do biê?n dạng tư?c thời của bê tông khi Ke?o căng ca?c ca?p
loss due to concrete shrinkag 	Mâ?t ma?t do co ngo?t bê tông
lost due to relaxation of prestressing stee 	Mâ?t ma?t do từ biê?n bê tông
lost due to relaxation of prestressing stee 	Mâ?t ma?t do tự chùng cô?t the?p dự ư?ng lực
low alloy stee 	The?p hợp kim thâ?p
low relaxation stee 	The?p co? độ tự chùng râ?t thâ?p
low slump concrete 	vữa bê tông co? độ sụt hình no?n thâ?p, vữa bê tông khô 
lower reinforcement laye 	Lơ?p cô?t the?p bên dươ?i
low-grade concrete resistanc 	Bê tông ma?c thâ?p
lump load 	sự châ?t tải đã kê?t tảng; tải vo?n cục; tải trọng tập trung 
machinability tes 	sự thử khả năng ma?y 
machine-placed concrete 	bê tông đổ bằng ma?y
machining tes 	sự thử ti?nh gia công trên ma?y 
main beam 	dầm chi?nh; chùm (tia) chi?nh 
main girder 	dầm chi?nh, dầm ca?i; xà chi?nh, xà ca?i 
main reinforcement parallel to traffi 	Cô?t the?p chủ song song hươ?ng xe chạy
main reinforcement perpendicular to traffi 	Cô?t the?p chủ vuông go?c hươ?ng xe chạy
mallet 	Ca?i vồ (thợ nề)
management meeting 	Họp quản ly?, họp điều độ
masonry bonds 	Ca?c ca?ch xây
mass concrete 	bê tông liền khô?i, bê tông không cô?t the?p 
matched load 	tải trọng được thi?ch ư?ng 
matured concrete 	bê tông đã cư?ng 
medium relaxation stee 	Cô?t the?p co? độ tự chùng bình thường
member with minimum reinforcemen 	Câ?u kiện co? hàm lượng cô?t the?p tô?i thiểu
mesh reinforcement 	cô?t (the?p) lươ?i 
metal shel 	Vỏ the?p
method of concrete curin 	Phương pha?p dưỡng hộ bê tông
middle girder 	dầm giữa, xà giữa 
midship beam 	dầm giữa tàu 
mild steel 	The?p non (the?p than thâ?p)
minor load 	tải trọng sơ bộ (trong ma?y thử độ cư?ng) 
miscellaneous load 	tải trọng hỗn hợp 
mix proportio 	Tỷ lệ pha trộn hỗn hợp bê tông
mixer operator 	công nhân đư?ng ma?y trộn vữa bê tông
mixing drum 	Trô?ng trộn bê tông
mobile load 	tải trọng di động 
model tes 	sự thử trên mô hình 
modular rati 	Tỷ sô? của ca?c mô dun đàn hồi the?p-bê tông
modular rati 	Tỷ sô? của ca?c mô dun đàn hồi the?p-bê tông
modulus of elasticity 	Môđun đàn hồi
momentary load 	tải trọng trong thời gian ngă?n, tải trọng tạm thời
monitoring tes 	sự thử kiểm tra 
monolayer reinforcement 	cô?t (the?p) một lơ?p 
monolithic concrete 	bê tông liền khô?i 
mortar 	vữa
mortar pan (mortar trough, mortar tub) 	thùng vữa
most efficient load 	công suâ?t khi hiệu suâ?t lơ?n nhâ?t (tuabin) 
motar trough 	Chậu vữa
movable castin 	Thiê?t bị di động đổ bê tông
movable form, travling for 	Va?n khuôn di động
movable load 	tải trọng di động 
movable rest beam 	dầm co? gô?i tựa di động 
moving load 	tải trọng động 
multilayer reinforcement 	cô?t (the?p) nhiều lơ?p 
multispan beam 	dầm nhiều nhịp 
nailable concrete 	bê tông đo?ng đinh được 
natural condition tes 	sự thử trong điều kiện tự nhiên 
needle beam 	dầm kim
negative moment reinforcemen 	cô?t (the?p) chịu mômen âm 
net load 	tải trọng co? i?ch, trọng lượng co? i?ch 
nodulation tes 	sự thử khả năng hình thành nô?t sần 
nomal load 	tải trọng bình thường 
non reactive load 	tải trọng không gây phản lực, tải thuần trở (điện) 
non-central load 	tải trọng lệch tâm 
non-destructive tes 	sự thử không pha? hủy (mẫu thử) 
non-fines concrete 	bê tông hạt thô
non-prestressed reinforcemen 	Cô?t the?p thường (không dự ư?ng lực)
non-uniform beam 	dầm tiê?t diện không đều 
normal relaxation stee 	The?p co? độ tự chùng thông thường
normal weight concrete, ordinary structural concret 	Bê tông trọng lượng thông thường
no-slump concrete 	bê tông cư?ng (bê tông co? độ sụt=0) 
notched bar bending tes 	sự thử uô?n mẫu bị că?t 
notched bar tes 	sự thử mẫu bị că?t 
notice 	Thông ba?o
oblique angled load 	tải trọng xiên, tải trọng lệch 
of laminated stee 	Bằng the?p ca?n
off-form concrete 	bê tông trong va?n khuôn
online tes 	sự thử trên đường dây 
on-load tes 	sự thử trên đường 
operating load 	tải trọng làm việc 
operation tes 	sự thử trong vận hành, sự thử trong thao ta?c, sự thử trong điều kiện sử dụng 
optimum load 	tải trọng tô?i ưu 
oscillating beam 	đòn dao động, đòn lă?c 
oscillating load 	tải (trọng) dao động 
other contractors 	Ca?c nhà thầu kha?c
outside cellar steps 	cửa sổ buồng công trình phụ
overall depth of membe 	Chiều cao toàn bộ của câ?u kiện
overall factor of safety 	Hệ sô? an toàn tổng thể
overla 	Nô?i chồng
overload tes 	sự thử qua? tải 
over-reinforced concret 	Bê tông co? qua? nhiều cô?t the?p
oxidation tes 	sự thử oxi ho?a 
panel girder 	dầm tâ?m, dầm panen 
parabolic girder 	dầm dạng parabôn 
parallel girder 	dầm song song 
parape 	Thanh nằm ngang song song của rào chă?n bảo vệ trên cầu (tay vịn lan can cầu)
parobolic arc 	cuô?n parabôn
partial load 	tải trọng từng phần 
partial prestressing 	Ke?o căng cô?t the?p từng phần
pay(ing) load 	tải trọng co? i?ch 
payment certificate 	Chư?ng nhận thanh toa?n
payment upon termination 	Thanh toa?n khi châ?m dư?t hợp đồng
peak load 	tải trọng cao điểm 
penetration tes 	sự thử độ thâ?m; sự thử độ xuyên (hàn) 
percussion tes 	sự thử va đập 
perfomance tes 	sự thử vận hành 
perforated cylindrical anchor hea 	?ầu neo hình trụ co? khoan lỗ
perfume concrete 	tinh dầu hương liệu 
perimeter of ba 	Chu vi thanh cô?t the?p 
periodic load 	tải trọng tuần hoàn 
permanent load 	tải trọng không đổi; tải trọng thường xuyên 
permeable concrete 	bê tông không thâ?m 
permissible load 	tải trọng cho phe?p 
personnel 	Nhân sự 
phantom load 	tải trọng giả 
pile bottom leve 	Cao độ chân cọc
pile cross sectional area 	Tiê?t diện ngang cọc
pile foundatio 	Mo?ng cọc
pile shaft area 	Diện ti?ch xung quanh cọc
pile sho 	Phần bọc the?p gia cô? mũi cọc
plain ba 	the?p trơn
plain concrete 	bê tông không cô?t the?p, bê tông thường 
plain concrete, unreinforced concret 	Bê tông không cô?t the?p
plain girder 	dầm khô?i 
plain round ba 	Cô?t the?p tròn trơn
plane girder 	dầm phẳng 
plank platform (board platform) 	sàn la?t va?n
plaster concrete 	bê tông thạch cao 
plaste 	Thạch cao
plastic concrete 	bê tông dẻo
plate bearin 	Gô?i bản the?p
plate girder 	dầm phẳng, dầm tâ?m 
plate load 	tải anôt 
plate stee 	the?p bản
plat 	The?p bản
platform railing 	lan can/tay vịn sàn (bảo hộ lao động)
plumb bob (plummet) 	dây dọi, quả dọi (bằng chì)
plywoo 	Gỗ da?n (va?n khuôn)
point load 	tải trọng tập trung 
pony girder 	dầm phụ 
poor concrete 	bê tông nghèo, bê tông gày 
porosit 	?ộ xô?p rỗng (của bê tông)
portland cement concret 	bê tông xi măng pooclan 
portland-cement, portland concret 	Bê tông ximăng
possession of the site 	Sở hữu công trường
post stressed reinforcement 	cô?t (the?p) ư?ng lực sau 
post-stressed concrete 	bê tông ư?ng lực sau 
post-tensioned concrete 	bê tông ư?ng lực sau 
posttensioning (apres betonage 	Phương pha?p Ke?o căng sau khi đổ bê tông
precast concrete 	bê tông đu?c sẵn 
precast concrete pil 	Cọc bê tông đu?c sẵn
precast concret 	Bê tông đu?c sẵn
precasting yar 	Xưởng đu?c sẵn kê?t câ?u bê tông
prefabricated concrete 	bê tông đu?c sẵn 
preliminary tes 	sự thử sơ bộ 
pre-operational tes 	sự thử trươ?c vận hành 
prepact concrete 	bê tông đu?c từng khô?i riêng 
pre-production tes 	sự thử trươ?c sản xuâ?t, sự thử trươ?c khi đưa vào sản xuâ?t 
pressure load 	tải trọng ne?n 
prestressed concrete 	bê tông ư?ng lực trươ?c 
prestressed concrete pil 	Cọc bê tông cô?t the?p dự ư?ng lực
prestressed concret 	Bê tông cô?t the?p dự ư?ng lực
prestressed girder 	dầm dự ư?ng lực 
pre-stressed reinforcement 	cô?t (the?p) ư?ng lực trươ?c 
prestressing be 	Bệ ke?o căng cô?t the?p dự ư?ng lực
prestressing by stage 	Ke?o căng cô?t the?p theo từng giai đoạn
prestressing stee 	The?p dự ư?ng suâ?t
prestressing steel, cabl 	Cô?t the?p dự ư?ng lực
prestressing teel stran 	Ca?p the?p dự ư?ng lực
prestressing tim 	Thời điểm Ke?o căng cô?t the?p
pretensioning (avant betonage 	Phương pha?p Ke?o căng trươ?c khi đổ bê tông
price adjustment 	?iều chỉnh gia?
printing beam 	(ma?y ti?nh) chùm tia in 
production tes 	sự thử trong sản xuâ?t; sự thử tại nhà ma?y 
programm 	Lịch tiê?n độ
proof load 	tải trọng thử 
property 	(Sở hữu) tài sản
protection against corrosio 	Bảo vệ cô?t the?p chô?ng rỉ
protective concrete cove 	Lơ?p bê tông bảo hộ
pulling tes 	sự thử ke?o 
pull-out bond tes 	sự thử độ di?nh của bê tông vơ?i cô?t the?p bằng ca?ch ke?o cô?t the?p 
pulsating load 	tải trọng mạch động 
pumice concrete 	bê tông đa? bọt 
pump concrete 	bê tông bơm 
pumping concret 	Bê tông bơm
punching tes 	sự thử đột lỗ 
push-pull tes 	sự thử ke?o-đẩy 
put in the reinforcement cas 	?ặt vào trong khung cô?t the?p
putlog (putlock) 	thanh giàn gia?o, thanh gio?ng
quaking concrete 	bê tông dẻo 
quality concrete 	bê tông châ?t lượng cao 
quality control 	Kiểm soa?t châ?t lượng
quenching tes 	sự thử bằng ca?ch tôi; mẫu thử độ thâ?m tôi
quick tes 	sự thử nhanh 
quiescent load 	tải trọng tĩnh 
racking (raking) back 	đầu chờ xây
racking load 	tải trọng dao động 
radial load 	tải trọng hươ?ng ki?nh 
radio (-frequency) beam 	chùm tần sô? vô tuyê?n điện 
railing loa 	Tải trọng lan can
railin 	Lan can trên cầu
rammed concrete 	bê tông đầm 
rapid tes 	sự thử nhanh 
rated load 	tải trọng danh nghĩa 
ratio of non- prestressing tension reinforcemen 	Tỷ lệ hàm lượng cô?t the?p thường trong mặt că?t
ratio of prestressing stee 	Tỷ lệ hàm lượng cô?t the?p dự ư?ng lực
reactivity tes 	sự thử hoạt ti?nh 
ready-mixed concrete 	bê tông trộn sẵn
reasonableness tes 	sự kiểm tra ti?nh hợp ly? 
rebound numbe 	Sô? bật nảy trên su?ng thử bê tông
reception tes 	sự thử nghiểm thu 
record drawings 	Bản vẽ hoàn công (như as-built drawings)
reedle vibrato 	?ầm dùi (để đầm bê tông)
refractory concrete 	bê tông chịu nhiệt 
reinforced concrete 	bê tông cô?t the?p 
reinforced concrete beam 	dầm bê tông cô?t the?p 
reinforced concrete bea 	Dầm bê tông cô?t the?p
reinforced concrete bea 	Dầm bê tông cô?t the?p
reinforced concrete lintel 	Lanh tô bê tông cô?t the?p
reinforced concret 	Bê tông cô?t the?p thường
reinforcement grou 	Nho?m cô?t the?p
relaxation tes 	sự thi? nghiệm ti?nh chùng (của vật liệu) 
removable gate 	Cửa tha?o rời được
removal of the concrete cove 	Bo?c lơ?p bê tông bảo hộ
renforced concrete bridg 	Cầu bê tông cột the?p thường
repeated load tes 	sự thử bằng tải trọng lặp lại 
resistive load 	tải thuần trở, tải ômic 
resonance tes 	sự thử bằng cộng hưởng 
resonant fatigue tes 	sự thử độ mỏi bằng cộng hưởng 
restrained beam 	dầm ngàm hai đầu 
retarde 	Phụ gia chậm ho?a cư?ng bê tông
retempered concrete 	bê tông trộn lại 
retension (money 	Tiền giữ lại (ở mỗi kỳ thanh toa?n, thường để giữ bảo hành) 
reversal load 	tải trọng đổi dâ?u 
ribbed plat 	The?p bản co? gân
rich concrete 	bê tông giàu, bê tông châ?t lượng cao 
ridge beam 	đòn no?c 
rigid arc 	vòm cư?ng; vòm không khơ?p
rigid reinforcement 	cô?t (the?p) cư?ng 
riveted girder 	dầm ghe?p ta?n đinh 
rod tes 	sự thử bằng thanh thăm dò 
rolled stee 	the?p ca?n
roof beam 	dầm ma?i 
round hollow sectio 	the?p hình tròn rỗng
round steel tub 	ô?ng the?p hình tròn
routine tes 	sự thử theo thủ tục; sự thử thường xuyên
rubbed concrete 	bê tông mài mặt 
rubber bearing, neoprene bearin 	Gô?i cao su
rubble concrete 	bê tông đa? hộc 
running-in tes 	sự thử chạy rà 
rupture limit of the prestressed stee 	Giơ?i hạn pha? hủy của cô?t the?p dự ư?ng lực
rupture strength 	Giơ?i hạn độ bền đư?t
rupture tes 	sự thử đư?t gãy 
rush-hour load 	tải trọng trong giờ cao điểm 
safe load 	tải trọng an toàn, tải trọng cho phe?p 
safety 	An toàn
sample tes 	sự thử chọn mẫu (để xa?c định phần trăm chi?nh phẩm)
sand concret 	Bê tông ca?t
sand-blasted concrete 	bê tôngmài bo?ng bề mặt
sandlight weight concret 	Bê tông nhẹ co? ca?t
scaffold pole (scaffold standard 	cọc giàn gia?o
scaffolding joint with chain (lashing, whip, bond 	mô?i nô?i giàn gia?o bằng xi?ch (dây chằng buộc, dây ca?p)
scale beam 	đòn cân 
scale model tes 	sự thử mô hình đồng dạng, sự thử mẫu đồng dạng 
scanning beam 	chùm tia que?t 
scattered beam 	chùm ta?n xạ 
scleroscope hardness tes 	sự thử độ cư?ng kiểu xung 
scratch hardness tes 	sự thử độ cư?ng kiểu vạch 
screen tes 	sự kiểm tra bằng sàng 
secondary beam 	dầm trung gian 
secondary girder 	dầm phụ 
securitie 	Ca?c khoản bảo lãnh
segmental girder 	dầm ca?nh biên trên cong 
segregating concrete 	vữa bê tông phân lơ?p 
segregatio 	Phân tầng khi đổ bê tông
semi-balloon-frame constructio 	kê?t câ?u khung nhà gỗ nhẹ vừa
semi-destructive tes 	sự thử ba?n hủy 
semi-fixed girder 	dầm cô? định một đầu 
sensitivity tes 	sự thử ti?nh nhạy cảm; sự thử độ mẫn cảm 
service load 	tải trọng sử dụng, tải trọng co? i?ch 
service tes 	sự thử vận hành; sự thử khai tha?c sử dụng 
setting load 	tải trọng khi lă?p ra?p 
shaft frictional capacity 	Ma sa?t xung quanh cọc
shallow beam 	dầm thâ?p 
shape stee 	The?p hình
shatter tes 	sự thử đập vỡ 
shear carried by concret 	Lực că?t do phần bê tông chịu
shear load 	lực că?t 
shear reinforcemen 	Cô?t the?p chịu că?t
shearing strength 	?ộ bền trượt
shearing tes 	sự thử bằng ca?ch că?t 
sheet pil 	Cọc va?n, cọc va?n the?p
sheet pil 	Cọc va?n, cọc va?n the?p
shock load 	tải trọng va chạm 
shock tes 	sự thử va đập 
short-circuit tes 	sự thử ngă?n mạch 
shutter 	cô?p pha 
signboard (billboard) 	Bảng ba?o hiệu
silicon stee 	the?p silic
simulation tes 	sự thử bằng phương pha?p mô phỏng 
single non central load 	tải trọng tập trung không đu?ng tâm 
single tes 	sự thử đơn chiê?c, sự thử từng ca?i 
single wine, individual wir 	Sợi đơn lẻ (cô?t the?p sợi)
site fence 	tường rào công trường
site hut (site office ) 	La?n (công trường)
site investigation report 	Ba?o ca?o khảo sa?t hiện trường
skin reinforcemen 	Cô?t the?p phụ đặt gần sa?t bề mặt
slab reinforced in both direction 	Bản đặt cô?t the?p hai hươ?ng
slab reinforcemen 	Cô?t the?p bản mặt cầu
slag concrete 	bê tông xỉ 
slender beam 	dầm mảnh
sliding agen 	Châ?t bôi trơn cô?t the?p dự ư?ng lực
sliding for 	Va?n khuôn trượt
sludge tes 	sự xa?c định hàm lượng cặn 
slump tes 	sự thử nghiệm độ sụt của vữa bê tông 
slum 	?ộ sụt (hình no?n) của bê tông
small girder 	dầm con; xà con 
snow load 	tải trọng (do) tuyê?t 
socle beam 	dầm hẫng; dầm công xôn 
socle girder 	dầm công xôn 
soil bearing tes 	sự thử khả năng chịu tải của đâ?t
soil tes 	sự thử đâ?t trồng 
solid web girder 	dầm khô?i 
solubility tes 	sự thử độ hòa tan
spacing of prestressing stee 	Khoảng ca?ch giữa ca?c cô?t the?p dự ư?ng lực
spalled concret 	Bê tông đã bị ta?ch lơ?p (bị bo?c lơ?p)
span/depth rati 	Tỷ lệ chiều dài nhịp trên chiều cao dầm
specified rated load 	tải trọng danh nghĩa 
specimen tes 	sự thử vật mẫu 
spiral reinforced colum 	Cột co? cô?t the?p xoă?n ô?c
spiral reinforcemen 	Cô?t the?p xoă?n ô?c
spirit level 	ô?ng ni vô của thợ xây
splice plat, sca 	Bản nô?i phủ
splic 	Nô?i ghe?p, nô?i dài ra
splicing metho 	Phương pha?p nô?i cọc
split beam 	dầm ghe?p, dầm tổ hợp 
sprayed concrete 	bê tông phun 
sprayed concrete, shotcrete 	Bê tông phun
spring beam 	dầm đàn hồi 
square hollow sectio 	the?p hình vuông rỗng
stack of bricks 	đô?ng gạch, chồng gạch
stacked shutter boards (lining boards 	?ô?ng van gỗ cô?p pha, chồng va?n gỗ cô?p pha
stainless stee 	the?p không gỉ
stamped concrete 	bê tông đầm 
standard brick 	gạch tiêu chuẩn
start date 	Ngày khởi công
static hardness tes 	sự thử độ cư?ng tĩnh 
static load 	tĩnh tải 
static tes 	sự thử tĩnh; sự thử bằng tải trọng tĩnh 
static torsion tes 	sự thử độ xoă?n tĩnh 
steady load 	tải trọng ổn định 
steadyưload tes 	sự thử bằng tải trọng không đổi
steamed concrete 	bê tông đã bô?c hơi nươ?c 
steamưpressure tes 	sự thử bằng a?p lực hơi nươ?c 
steel concrete 	bê tông cô?t the?p 
steel elongatio 	?ộ dãn dài của cô?t the?p
steel h pil 	Cọc the?p hình H 
steel percentag 	Hàm lượng the?p trong bê tông cô?t the?p
steel percentag 	Hàm lượng the?p trong bê tông cô?t the?p
steel pipe filled wit 	ô?ng the?p nhồi bê tông
steel pipe filled wit 	ô?ng the?p nhồi bê tông
steel pipe pile, tubular steel pil 	Cọc ô?ng the?p
steel stress at jacking en 	ư?ng suâ?t the?p ở đầu ki?ch Ke?o căng
steel with particular propertie 	The?p co? ti?nh châ?t đặc biệt
stee 	the?p
stiff concrete 	vữa bê tông cư?ng, vữa bê tông đặc 
stiff reinforcement 	cô?t (the?p) cư?ng 
stiffened angle 	Neo bằng the?p go?c co? sườn tăng cường
stiffening girder 	dầm cư?ng 
stirrup,link,lateral ti 	Cô?t the?p đai (dạng thanh)
stone concrete 	bê tông đa? dăm 
straight reinforcemen 	Cô?t the?p thẳng
straining beam 	thanh giằng, thanh ke?o 
strenghening stee 	The?p tăng cường
strength tes 	sự thử độ bền 
strengthening reinforcemen 	Cô?t the?p tăng cường thêm
stress at anchorages after seatin 	ư?ng suâ?t cô?t the?p dự ư?ng lực ở sa?t neo sau khi tha?o ki?ch
stretching bond 	ca?ch xây hàng dài (gạch xây dọc)
stretching course 	hàng, lơ?p xây dọc
structral hollow sectio 	the?p hình rỗng làm kê?t câ?u
structural engineerin 	kê?t câ?u
structural sectio 	the?p hình xây dựng
structural stee 	The?p kê?t câ?u
structural tes 	sự thử câ?u tru?c 
strutting beam 	dầm ngang, xà ngang; thanh giằng (vì kèo) 
stud shear connecto 	Neo kiểu đinh (của dầm the?p liên hợp bê tông)
stud shear connecto 	Neo kiểu đinh (của dầm the?p liên hợp bê tông)
subcontracting 	Thầu phụ
subcontractor 	Nhà thầu phụ
successiv 	Nô?i tiê?p nhau
sudden load 	tải trọng đột ngột, sự châ?t tải đột ngột, sự châ?t tải đột biê?n 
suddenly applied load 	tải trọng ta?c dụng đột biê?n 
sum of skin friction 	Tổng ma sa?t (vỏ)
superelevatio 	Siêu cao
superimposed load 	tải trọng phụ thêm 
supersonic tes 	sự thử bằng siêu âm 
supporting beam 	dầm đỡ, xà đỡ 
surcharge load 	sự qua? tải 
surface load 	tải trọng bề mặt 
suspension girder 	dầm treo 
suspension of wor 	Tạm ngừng thi công
sustained load 	tải trọng ta?c động lâu dài 
symmetrical load 	tải trọng đô?i xư?ng, sự châ?t tải đô?i xư?ng 
t- beam 	dầm chữ T 
t- girder 	dầm chữ T 
tail load 	tải trọng lên đuôi (ma?y bay) 
taking over 	bàn giao
tamped concrete 	bê tông đầm 
tampin 	?ầm bê tông cho chặt
tangetial load 	tải trọng tiê?p tuyê?n 
tar concrete 	bê tông nhựa đường 
tax 	thuê?
tee girder 	dầm chữ T 
temporary work 	Ca?c công trình tạm (của nhà thầu)
tenacity tes 	sự thử độ dai; sự thử độ bền đư?t 
tensile load 	tải trọng ke?o đư?t 
tensile strength 	Giơ?i hạn bền ke?o
tensile strength at days ag 	Cường độ chịu ke?o của bê tông ở ngày
tensile tes 	sự thử sư?c căng; sự thử ke?o 
tension reinforcement 	cô?t (the?p) chịu ke?o 
tension reinforcemen 	Cô?t the?p chịu ke?o
tension tes 	sự thử sư?c căng; sự thử ke?o 
tension zone in concret 	Khu vực chịu Ke?o của bê tông
tensioning (tensioning operation 	Công ta?c ke?o căng cô?t the?p
terminating load 	tải trọng đặt ở đầu mu?t (dầm) 
termination 	Ngừng, châ?m dư?t (hợp đồng)
test cube, cub 	Mẫu thử khô?i vuông bê tông
test load 	tải trọng thử 
tests 	Kiểm tra, thử nghiệm
the works to be completed by the intended completion date 	Công trình phải được hoàn thành vào Ngày hoàn thành dự kiê?n
thermal tes 	sự thử bằng nhiệt 
thick lead pencil 	bu?t chì đầu đậm (dùng để đa?nh dâ?u)
three-hinged arc 	vòm ba khơ?p
through beam 	dầm liên tục, dầm suô?t 
thrust reinforcement 	cô?t (the?p) chô?ng că?t 
tilting load 	tải trọng lật đổ 
time control 	kiểm soa?t tiê?n độ
to extend reinforcemen 	Ke?o dài cô?t the?p
tool stee 	the?p công cụ
top beam 	dầm sàn; dầm đỉnh 
top lateral stru 	Thanh giằng ngang ở mọc thượng của dàn
top latera 	Thanh giằng che?o ở mọc thượng của dàn
top reinforcemen 	Cô?t the?p bên trên (của mặt că?t)
torque load 	tải trọng xoă?n 
torsion tes 	sự thử xoă?n 
tosbo 	Khoan
total angular change of tendon profile from anchor to point  	Tổng ca?c go?c uô?n nghiêng của cô?t the?p dự ư?ng lực ở Khoảng ca?ch x kể từ mἯfont>
total angular change of tendon profile from jaching end to point  	Tổng ca?c go?c uô?n của đường trục cô?t the?p dự ư?ng lực từ đầu ki?ch đê?n
total load 	tải trọng toàn phần, tải trọng tổng 
toughness tes 	sự thử độ dai (va đập) 
traction load 	tải trọng ke?o 
traction tes 	sự thử sư?c ke?o 
traffic load 	tải trọng chuyên chở 
transient load 	tải trọng ngă?n hạn, tải trọng nhâ?t thời 
transit-mix concrete 	bê tông trộn trên xe 
transonic tes 	sự thử bằng xuyên âm 
transverse beam 	dầm ngang, đà ngang 
transverse reinforcemen 	Cô?t the?p ngang
transverse strength 	?ộ bền uô?n ngang
transverse tes 	sự thử uô?n ngang 
transversely loaded beam 	dầm chịu tải trọng ngang 
trass concrete 	bê tông puzolan 
trellis girder 	giàn mă?t ca?o 
tremie concrete 	bê tông đổ dươ?i nươ?c 
trial load 	tải trọng thử 
trial tes 	phe?p thử sơ bộ 
trough girder 	dầm chữ U, dầm lòng ma?ng 
trowel 	ca?i bay thợ nề
trussed arc 	vòm giàn
trussed beam 	dầm giàn, dầm mă?t ca?o 
trussed girder 	dầm vượt suô?t; giàn vượt suô?t 
tubular girder 	dầm ô?ng 
tuned plate load 	tải điều hươ?ng (trong mạch anôt) 
twist step of a cabl 	Bươ?c xoă?n của sợi the?p trong bo? xoă?n
twisting tes 	sự thử xoă?n
two-hinged arc 	vòm hai khơ?p
two-way reinforcement 	cô?t (the?p) hai hươ?ng
ultimate bending strength 	Giơ?i hạn bền uô?n
ultimate compressive strength 	Giơ?i hạn bền ne?n
ultimate load 	tải trọng giơ?i hạn 
ultimate strength 	Giơ?i hạn bền
ultrasonic tes 	sự thử bằng siêu âm 
un*****ed concrete sectio 	Mặt că?t bê tông chưa bị nư?t
unbalanced load 	tải trọng không cân bằng 
unbonded tendo 	Cô?t the?p dự ư?ng lực không di?nh ba?m vơ?i bê tông
unbonded tendo 	Cô?t the?p dự ư?ng lực không di?nh ba?m vơ?i bê tông
uncorrected defects 	Ca?c sai so?t không được sửa chữa
unfilled tubular steel pil 	Cọc ô?ng the?p không lâ?p lòng
uniform beam 	dầm tiê?t diện không đổi, dầm (co?) mặt că?t đều 
uniform load 	tải trọng đều 
unit load 	tải trọng riêng, tải trọng trên đơn vị diện ti?ch 
up load 	tải trọng thẳng đư?ng lên trên (lực nâng) 
upper floo 	Tầng trên
upsetting tes 	sự thử co, sự thử chồn 
useful load 	tải trọng co? i?ch 
utility room doo 	cửa buồng công trình phụ
utility room window 	cửa sổ buồng công trình phụ
vacuum concrete 	bê tông chân không 
variable load 	tải trọng biê?n đổi 
variations 	Ca?c thay đổi ( Chủ đầu tư yêu cầu Nhà thầu thực hiện một công việc nào đo? kha?c đi so vơ?i hợp đồng ban đầu)
varying load 	tải trọng biê?n đổi 
vertical clearanc 	Chiều cao tịnh không
vertical-ti 	Neo dạng thanh thẳng đư?ng để nô?i phần bê tông cô?t the?p kha?c nhau
vertical-ti 	Neo dạng thanh thẳng đư?ng để nô?i phần bê tông cô?t the?p kha?c nhau
vertical-ti 	Neo dạng thanh thẳng đư?ng để nô?i phần bê tông cô?t the?p kha?c nhau
viaduc 	Cầu co? trụ cao
vibrated concrete 	bê tông đầm rung 
vibration tes 	sự thử độ rung 
vierendeel girder 	giàn Vierenddeel (giàn Bỉ)
wall ancho 	neo (vào) tường
wall beam 	dầm tường 
warranty tes 	sự thử nghiệm thu 
warren girder 	giàn biên //mạng tam gia?c
water cured concrete 	bê tông dưỡng hộ trong nươ?c 
water tes 	sự thử thủy lực 
wearing test 	sự thử mài mòn 
weathering steel (need not be painted 	The?p chịu thời tiê?t (không cần sơn)
web girder 	giàn lươ?i the?p, dầm đặc
web reinforcemen 	Cô?t the?p trong sườn dầm
weldability tes 	sự thử ti?nh hàn 
welded plate girde 	Dầm bản the?p hàn
welded wire fabric, welded wire mes 	Lươ?i cô?t the?p sợi hàn
welding tes 	sự thử bằng hàn 
wet concrete 	vữa bê tông dẻo 
wet gunitin 	Phun bê tông ươ?t
wheel load 	a?p lực lên ba?nh xe 
wheelbarrow 	Xe cu?t ki?t, xe đẩy tay
whole beam 	dầm gỗ 
wind beam 	xà chô?ng gio? 
wind bracin 	Giằng gio?
wind load 	tải trọng (do) gio? 
window ledge 	Ngưỡng (bậu) cửa sổ 
wind-tunnel tes 	sự thử bằng ô?ng khi? động học
wooden beam 	xà gồ, dầm gỗ 
work platform (working platform) 	Bục kê để xây
workable concrete 	bê tông dễ đổ 
working beam 	đòn cân bằng; xà vồ (để đập quặng) 
working load 	tải trọng làm việc
writing beam 	tia viê?t 
yeild point stress of prestressing stee 	ư?ng suâ?t đàn hồi của cô?t the?p dự ư?ng lực
yield strength 	Giơ?i hạn chảy, ư?ng suâ?t chảy
yield strength of rein forcement in compressio 	Cường độ đàn hồi của the?p lu?c ne?n
yield strength of reinforcement in tensio 	Cường độ đàn hồi của the?p lu?c ke?o
z- beam 	dầm chữ Z
zonolite concrete 	bê tông zônôlit (bê tông ko thâ?m nươ?c)
